111111111111111111111111111111111111111
111111111110000000000000000011111111111
11111111110000000000M000000011000001111
111111111000000000000000000000000M01111
111111100000000000000000000001111111111
111110000000000000000000000000000000001
100000000000000000000C00000000000000011
100000000000000000000000000000000000011
10000000000P000000000000000000001111111
100000000000000001100000000000000011111
111110000000000001100000000001111111111
111111111100000000000000000000000000011
101100000000000000000000000C00000000011
100000000000000000000000000000000000001
100000100000000000000000000110001111101
100000C00000000000000000001100000000101
100000000000000000000000011001001111101
1100E0000000000000000000011111101100001
100111000000000011100000000001001111101
111111111111111111111111111111111111111