111111111111111111111111111111111111111
111111111110000000000000000011111111111
11111111110000000000M0000000110C0001111
111111111000000000000000000000000M01111
1111111C0000000000000000000001111111111
111110000000000000000000000000000000001
100000000000000000000C00000000000000011
100000M00000000000000000000000000000011
10000000000P000000000000000000001111111
1000000000000M000110000C000000000011111
1111100000000000M1100000000001111111111
111111111100000000000000000000000000011
10110000M000000000000000000C00000000011
100000000000000000000000000000000000001
100000C00000000000000000000110001111101
100000000000000000000000001100000000101
100000000000000000000000011001001111101
1000E0000000M00000000000011111101100001
10011100000000001C100000000001001111101
100000000000000000000000000000000000001
111111111111111111111111111111111111111