11111111111111111111111111111
1111P00000110110000000C001111
11111100010010010000000000011
11000000010000010000000M00011
11101000001000100000001111111
1000001C000101000111000000111
11000011100010000000000000011
111111100M000C00000110000M111
111111111100000000001E00C1111
11111111111111111111111111111