11111111111111
1100M00100E0C1
11000000000001
100010001000C1
1P011M0C1M0111
11111111111111